# Creature

Baboon hawk=Paviaanihaukka
Barber=Parturi
Bracken=Sananjalka
Bunker spider=Bunkkerihämähäkki
Butler=Hovimestari
Circuit bees=Piirimehiläiset
Coil-head=Kierrepää
Earth Leviathan=Maaleviatan
Eyeless dog=Silmätön kissa
Forest Giant=Metsäjätti
Forest keeper=Metsänvartija
Ghost girl=Aavetyttö
Hoarding bug=Rohmujuuta
Hygrodere=Hygrolima
Jeb=Jakke
Jester=Narri
Kidnapper fox=Sieppaajakettu
Landmine=Maamiina
Manticoil=Vyyhtisirkku
Masked=Naamioitu
Mask Hornets=Naamioherhiläinen
Nutcracker=Pähkinänsärkijä
Old Bird=Vanha Lintu
Roaming locusts=Vaeltavat kulkusirkat
Snare flea=Ansakirppu
Spore lizard=Itiölisko
Thumper=Tömistelijä
Tulip Snake=Tulppaanikäärme
Turret=Tykkitorni
Vain Shroud=Suonipensas
