# Interactive

[Cannot pull valve]=[Venttiiliä ei voi vetää]
[Hands full]=[Kädet täynnä]
[ Not holding items ]=[ Ei esineitä pideltynä ]
[Nothing to store]=[Ei mitään säilöttävää]
[Wait for ship to land]=[Odota aluksen laskeutumista]

Access terminal : [E]=Avaa terminaali ：[E]
Beam up : [E]=Teleporttaa : [E]
Charge item : [E]=Lataa esine ：[E]
Climb : [E]=Kiipeä ：[E]
Close door : [E]=Sulje ovi ：[E]
Confirm: [B]   |   Rotate: [R]   |   Store: [X]=Hyväksy：[B]   |   Käännä：[R]   |   Säilö：[X]
Disable speaker: [E]=Sammuta kaiutin：[E]
Enter: [E]=Astu sisään：[E]
Enter : [E]=Astu sisään ：[E]
Exit: [E]=Poistu：[E]
Exit : [E]=Poistu ：[E]
Flip switch: [E]=Käännä kytkintä：[E]
Get log : [E]=Kerää loki ：[E]
Grab : [E]=Poimi ：[E]
Inspect: [Z]=Tutki：[Z]
Land ship : [E]=Laskeudu ：[E]
Let go : [E]=Päästä irti ：[E]
Lift glass : [E]=Nosta lasi ：[E]
Open : [E]=Avaa ：[E]
Open door : [E]=Avaa ovi ：[E]
Open hatch : [E]=Avaa luukku ：[E]
Power button : [Q]=Virtapainike ：[Q]
Quit terminal : [TAB]=Poistu terminaalista ：[TAB]
Ring bell: [E]=Soita kelloa：[E]
Scan : [RMB]=Skannaa ：[RMB]
Sell item : [E]=Myy esine ：[E]
Send voice : [LMB]=Puhu ：[LMB]
Sprint: [Shift]=Juokse：[Shift]
Start game : [E]=Aloita peli ：[E]
Start ship : [E]=Käynnistä alus ：[E]
Store item : [E]=Säilö esine ：[E]
Swing shovel : [LMB]=Heilauta lapiota ：[LMB]
Swing sign : [LMB]=Heilauta kylttiä ：[LMB]
Switch camera : [E]=Vaihda kameraa ：[E]
Switch lights : [E]=Kytke valot päälle/pois ：[E]
Take TZP : [LMB]=Ota TZP:tä ：[LMB]
Toggle light : [LMB]=Kytke valo päälle/pois : [LMB]
Turn on/off : [E]=Kytke päälle/pois ：[E]
Turn page : [Q/E]=Käännä sivua : [Q/E]
Use airhorn : [LMB]=Käytä ilmatorvea ：[LMB]
Use cash register : [LMB]=Käytä kassakonetta ：[LMB]
Use door : [E]=Käytä ovea ：[E]
Use hairdryer : [LMB]=Käytä hiustenkuivaajaa ：[LMB]
Use horn : [LMB]=Käytä torvea ：[LMB]
Use key : [LMB]=Käytä avainta : [LMB]
Use ladder : [E]=Käytä tikapuita ：[E]
Use remote : [LMB]=Käytä kaukosäädintä ：[LMB]
Walk : [W/A/S/D]=Kävele : [W/A/S/D]