# Items

Airhorn=Ilmatorvi
Apparatice=Aparaatti
Apparatus=Aparaatti
Bee hive=Mehiläispesä
Bell=Kello
Big bolt=Suuri pultti
Body=Ruumis
Boombox=Mankka
Bottles=Kaljakori
Brake lever=Jarruvipu
Brass bell=Messinkikello
Brush=Hiusharja
Bubblegum=Purkkapallo
Candy=Karkki
Cash register=Kassakone
Chemical jug=Kemikaalisäiliö
clipboard=Kirjoituslevy
Clown horn=Pelletorvi
Coffee mug=Kahvikuppi
Cog=Ratas
Comedy=Komedia
Cookie mold pan=Keksipelti
Data chip=Datasiru
Dentures=Tekohampaat
Double-barrel=Haulikko
Dust pan=Rikkalapio
Echo scanner=Kaikuluotain
Egg beater=Vispilä
Extension ladder=Ekstensiotikapuut
Fancy lamp=Hieno lamppu
Fancy ring=Hieno sormus
Flashlight=Taskulamppu
Flask=Mittapullo
Gift=Lahja
Gift box=Lahjapaketti
Gold bar=Kultaharkko
Gold Bar=Kultaharkko
Golden cup=Kultamalja
Hair brush=Hiusharja
Hairdryer=Hiustenkuivain
Hive=Mehiläispesä
Homemade flashbang=Kotikutoinen valokranaatti
Homemade Flashbang=Kotikutoinen valokranaatti
Inverse teleporter=Käänteinen teleportti
Jack o' lantern=Kurpitsalyhty
Jar of pickles=Suolakurkkupurkki
Jetpack=Rakettireppu
Key=Avain
Large axle=Suuri akseli
Laser pointer=Laserosoitin
Lockpicker=Tiirikka
Loud horn=Kovaääninen torvi
Magic 7 ball=Maaginen 7-pallo
Magnifying glass=Suurennuslasi
Metal sheet=Metallilevy
Mug=Kahvikuppi
Old phone=Vanha puhelin
Painting=Maalaus
Perfume bottle=Hajuvesipullo
Pill bottle=Pilleripurkki
Plastic fish=Muovikala
Pro-flashlight=Pro-taskulamppu
Radar-booster=Tutkakiihdytin
Radar booster=Tutkakiihdytin
Red soda=Punainen limu
Remote=Kauko-ohjain
Ring=Sormus
Robot Toy=Robottilelu
Romantic table=Romanttinen pöytä
Rubber ducky=Kumiankka
Rubber Ducky=Kumiankka
Ship=Alus
Shotgun=Haulikko
Shotgun shell=Haulikon ammus
Shotgun Shell=Haulikon ammus
Shovel=Lapio
Shower=Suihku
Signal Translator=Signaalinkääntäjä
Sneakers=Tennaripari
Spray paint=Spraymaali
Steering wheel=Ohjauspyörä
Sticky note=Muistilappu
Stop sign=Stop-merkki
Stun grenade=Lamautuskranaatti
Table=Pöytä
Tattered metal sheet=Repaleinen metallilevy
Tea kettle=Teepannu
Tea Kettle=Teepannu
Teeth=Tekohampaat
Teleporter=Teleportti
Toilet=Vessanpönttö
Tragedy=Tragedia
TZP-Inhalant=TZP-Inhalaattori
Toothpaste=Hammastahna
Toy cube=Lelukuutio
Toy robot=Robottilelu
V-type engine=V-tyypin moottori
Walkie-talkie=Radiopuhelin
Wedding ring=Vihkisormus
Whoopie cushion=Pierutyyny
Yield sign=Kolmiomerkki
Zap gun=Lamautin